0,0,0,0,g
0,0,0,0,0
0,0,s,h,0
0,0,b,0,0
0,0,0,0,0
