0,0,0,0,0
0,b,b,0,0
0,b,g,0,0
v,0,0,0,0
s,b,b,b,b
