0,0,s,0,0
0,0,v,0,0
0,0,0,x,0
0,0,0,x,0
0,0,g,0,0
