0,0,0,0,0
0,0,0,0,0
0,0,0,0,0
v,0,0,h,0
s,b,b,g,0
