0,0,0,0,0
0,x,0,x,0
0,0,0,0,0
v,x,0,x,0
s,0,0,b,g
